  AbyssHeraldMod = "abyssherald",
  AbyssLectorElectroMod = "abysslectorelectro",
  AbyssLectorPyroMod = "abysslectorpyro",
  AndriusMod = "andrius",
  AzhdahaMod = "azhdaha",
  BigSlimeDendroMod = "bigslimedendro",
  BlackSerpentWindcutterMod = "blackserpentwindcutter",
  CryoHypostasisMod = "cryohypostasis",
  DvalinMod = "dvalin",
  ElectroHypostasisMod = "electrohypostasis",
  ElectroRegisvineMod = "electroregisvine",
  FatuiElectroCicinMageMod = "fatuielectrocicinmage",
  FatuiMirrorMaidenMod = "fatuimirrormaiden",
  HilichurlMod = "hilichurl",
  KairagiFieryMod = "kairagifiery",
  KairagiThunderMod = "kairagithunder",
  LaSignoraHarbingersMod = "lasignoraharbingers",
  LawachurlGeoMod = "lawachurlgeo",
  MagatsuMitakeNarukaminoMikotoMod = "magatsumitakenarukaminomikoto",
  MitachurlMod = "mitachurl",
  RuinGuardMod = "ruinguard",
  RuinHunterMod = "ruinhunter",
  TartagliaDelusionMod = "tartagliadelusion",
  TartagliaHarbingersMod = "tartagliaharbingers",
  PyroSlimeMod = "pyroslime",
  LargePyroSlimeMod = "largepyroslime"
  HydroSlimeMod = "hydroslime",
  LargeHydroSlimeMod = "largehydroslime",
  AnemoSlimeMod = "anemoslime",
  LargeAnemoSlimeMod = "largeanemoslime",
  ElectroSlimeMod = "electroslime",
  LargeElectroSlimeMod = "largeelectroslime",
  MutantElectroSlimeMod = "mutantelectroslime",
  DendroSlimeMod = "dendroslime",
  LargeDendroSlimeMod = "largedendroslime",
  CryoSlimeMod = "cryoslime",
  LargeCryoSlimeMod = "largecryoslime",
  GeoSlimeMod = "geoslime",
  LargeGeoSlimeMod = "largegeoslimemod",
  EyeOfTheStormMod = "eyeofthestorm",
